11111111111111
1P0C000E000001
11111111111111
