111111111111111
1P00C0000E00001
100000000000001
100C0000C000001
10000C00C000001
111111111111111
