11111111111111111111111
1C000000C0100000001C1C1
111111101C1C11111110101
1P000000100010000000101
11111010111111110110101
100000100C0010000C10101
10111011111110111011101
100010101C0C0010101C001
10111010101C1110101C111
101000001C10100000001C1
10101111101010000110101
101C1000000C10100010101
11101011111C10111011101
1C001010001010101000001
10101011101110101111111
1010100010100000100C0C1
10101110101011111011101
1C10100010C0100000000E1
10101011111011101011111
1C100C10000C000010000C1
11111111111111111111111
