11111111111111111
1CCCCCCCCCCCCCCC1
1C11C11C1C11C11C1
1CCCCCCCCCCCCCCC1
1C11C1C111C1C11C1
1CCCC1CC1CC1CCCC1
1111C11C1C11C1111
1111C1CC1CC1C1111
1111C1C1E1C1C1111
1CCCCCCCCCCCCCCC1
1111C1C111C1C1111
1111C1C111C1C1111
1CCCCCCC1CCCCCCC1
1C11C11C1C11C11C1
1CC1CCCCPCCCC1CC1
11C1C1C111C1C1C11
1CCCC1CC1CC1CCCC1
1C11111C1C11111C1
1CCCCCCCCCCCCCCC1
11111111111111111
